##################################################################################################################################
#O          #                        #                                                           #                               #
#            #                      #   #######         #  #  #  #  #  #  #  #  #  #  #  #        #                              #
#             #                    #    #     #        #  #  #  #  #  #  #  #  #  #  #  #          #                             #
#              #                  #     # #X# #       #  #  #  #  #  #  #  #  #  #  #  #                                         #
#               #                #      #  #  #      #                                 #  #                                      #
#                #              #       #     #     ###################################  #  ##                                   #
#                 #            #        #    #     #                                    #  # #    ##                             #
#                  #          #         #   #     #  #  #  #   #  #  #  #  #  #  #  #  #  #  #  ##                               #
#                 #            #        #  #     #  #  #  #   #  #  #  #  #  #  #  #  #  #  ## #                                 #
#                #              #       # #     #  #  #  #   #  #  #  #  #  #  #  #  #  #    ##  #                               #
#               #                #      # #    #  #  #  #   #  #  #  #  #  #  #  #  #  #   #    #                                #
#              #                  #     # #   #  #  #  #   #  #  #  #  #  #  #  #  #  #  ### ###  #                              #
#             #                    #    # #  #  #  #  #   #  #  #  #  #  #  #  #  #  #   #       #                               #
#            #                   ####   # # #  #  #  #   #  #  #  #  #  #  #  #  #  #    # ######  #                             #
#           #                    #   #  # #                                      #       #        #                              #
#          #                     # #  # # ################################################## #####                               #
#         #                      #  #   # #                                                  #                                   #
#        #                        #  ####   #                                                #                                   #
#       #                          #  # ####                                                 #                                   #
#      #                            #   #                                                    #                                   #
#     #                              #  #                                                    #                                   #
#    #                                # #                                                    #                                   #
##  #                                   #                                                    #                                   #
#  #                                    #                                                    #                                   #
# #                                     #                                                    #                                   #
#                                       #                                                    #                                   #
#                                       #                                                    #                                   #
#                                       #                                                    #                                   #
#                                       #                                                    #                                   #
#                                       #                                                    #                                   #
#                                       #                                                    #                                   #
#                                       #                                                    #                                   #
#                                       #                                                    #                                   #
#                                       #                                                    #                                   #
#                                       #                                                    #                                   #
#                                       #                                                    #                                   #
#                                       #                                                    #                                   #
#                                       #                                                    #                                   #
#                                       #                                                    #                                   #
##################################################################################################################################
